# Common Sandhi List
# ==================
# The list is used for cutting words in the Reader.
# Lines started with '#' will be ignored.
# Only lowercase words are acceptable.
# Format: 
#         word=part1+part2+...
#
nāhaṃ=na+ahaṃ
yaṃnūnāhaṃ=yaṃnūna+ahaṃ
panāhaṃ=pana+ahaṃ
khvāhaṃ=kho+ahaṃ
cāhaṃ=ca+ahaṃ
sacāhaṃ=sace+ahaṃ
handāhaṃ=handa+ahaṃ
svāhaṃ=so+ahaṃ
idhāhaṃ=idha+ahaṃ
tāhaṃ=te+ahaṃ
vatāhaṃ=vata+ahaṃ
evāhaṃ=eva+ahaṃ
tyāhaṃ=tyā+ahaṃ
tadāhaṃ=tadā+ahaṃ
tassāhaṃ=tassa+ahaṃ
kadāhaṃ=kadā+ahaṃ
yenāhaṃ=yena+ahaṃ
sāhaṃ=sā+ahaṃ
sohaṃ=so+ahaṃ
svāhaṃ=so+ahaṃ
tathāhaṃ=tathā+ahaṃ
tenāhaṃ=tena+ahaṃ
imāhaṃ=imā+ahaṃ
tāvāhaṃ=tāva+ahaṃ
apāhaṃ=api+ahaṃ
yathāhaṃ=yathā+ahaṃ
ekāhaṃ=ekā+ahaṃ
ekohaṃ=eko+ahaṃ
tathūpamāhaṃ=tathā+upamā+ahaṃ
esāhaṃ=esā+ahaṃ
esohaṃ=eso+ahaṃ
athāhaṃ=atha+ahaṃ
imināhaṃ=iminā+ahaṃ
nāmāhaṃ=nāma+ahaṃ
tesāhaṃ=tesā+ahaṃ
kathāhaṃ=kathaṃ+ahaṃ
māhaṃ=mā+ahaṃ
ekamidāhaṃ=ekaṃ+idha+ahaṃ
yāvāhaṃ=yāva+ahaṃ
kyāhaṃ=kiṃ+ahaṃ
vāhaṃ=vā+ahaṃ
tasmāhaṃ=tasmā+ahaṃ
yvāhaṃ=yo+ahaṃ
yadāhaṃ=yadā+ahaṃ
idānāhaṃ=idāni+ahaṃ
hetaṃ=hi+etaṃ
hetāni=hi+etāni
nohetaṃ=no+hi+etaṃ
sametāyasmā=sametu+āyasmā
matthi=me+atthi
asantettha=asanto+ettha
nasi=na+asi
yassete=yassa+ete
māvuso=mā+āvuso
itthāyaṃ=itthī+ayaṃ
ānentetaṃ=ānentu+etaṃ
metaṃ=me+etaṃ
mokāso=me+okāso
esāvuso=eso+āvuso
kutettha=kuto+ettha
sāpi=sā+api
sopi=so+api
sāva=sā+iva
bandhusseva=bandhussa+iva
tassedaṃ=tassa+idaṃ
latāva=latā+iva
lateva=latā+iva
ceti=ca+iti
guṇeneti=guṇena+iti
cūbhayaṃ=ca+ubhayaṃ
saddhīdha=saddhā+idha
tatrāyaṃ=tatra+ayaṃ
nāyyo=na+ayyo
nāssa=na+assa
māyyo=mā+ayyo
māssu=mā+assu
tadāssu=tadā+assu
kadāssu=kadā+assu
vāssa=vā+assa
tasmāssa=tasmā+assa
tatrāssa=tatra+assa
taṇhāssa=taṇhā+assa
katvātra=katvā+atra
sādhūti=sādhu+iti
tyāhaṃ=te+ahaṃ
tyāssa=te+assa
myāyaṃ=me+ayaṃ
khvassa=kho+assa
yvāyaṃ=yo+ayaṃ
svāyaṃ=so+ayaṃ
svāssa=so+assa
svāgataṃ=su+āgataṃ
hetuttho=hetu+attho
hetuattho=hetu+attho
dhātuttho=dhātu+attho
iccassa=iti+assa
iccetaṃ=iti+etaṃ
itīti=iti+iti
itīdaṃ=iti+idaṃ
itveva=iti+eva;
idheva=idha+eva
yathariva=yathā+eva
tathariva=tathā+eva
manuññaṃ=mano+aññaṃ
gavassaṃ=go+assaṃ
yajjevaṃ=yadi+evaṃ
yathayidaṃ=yathā+idaṃ
sammadeva=sammā+eva
yasmātiha=yasmā+iha
sabbhireva=sabbhi+eva
yāvañcidha=yāva+ca+idha
taññeva=taṃ+eva
evañhi=evaṃ+hi
yañce=yaṃ+ce
tañce=taṃ+ce
yañhi=yaṃ+hi
tañhi=taṃ+hi
tamahaṃ=taṃ+ahaṃ
tamāha=taṃ+āha
yamāha=yaṃ+āha
tamāhu=taṃ+āhu
yamāhu=yaṃ+āhu
evametaṃ=evaṃ+etaṃ
ahameva=ahaṃ+eva
tvameva=tvaṃ+eva
tayidaṃ=taṃ+idaṃ
tadate=taṃ+te
etadakiñci=etaṃ+kiñci
tāsāhaṃ=tāsaṃ+ahaṃ
idampi=idaṃ+api
kindāni=kiṃ+idāni
tvaṃsi=tvaṃ+asi
tadaminā=taṃ+iminā
evumaṃ=evaṃ+imaṃ
kahaṃ=kaṃ+ahaṃ
kehaṃ=kaṃ+ahaṃ
tampi=taṃ+pi
yampi=yaṃ+pi
nālaṃ=na+alaṃ
alañca=alaṃ+ca
